DDDDDDDDDDDDDDDDDDNNDDDD
DDDDDDDDDDDDDDDDDEEEEEDD
EEEDDDDDDDDDDEDDEDEEEDDD
DDDDDDDDDDDDDDDDEDEDDDED
MDDDMDDDDDEEEEDDDDEEEDDD
GGDDGDDEEEEEEEEEEEEDDDDD
DDDDDDDEEDDDDGDDDMDDDDDD
GDGDMDDEEEEEEDDDDDDDDDDD
DDDDDDDEEEDEDDDDEEEDDDDM
EEEEEEEEEDDDDDDDDDGDDDDD
EEDDDDDDDDDGDDGDDGDDMDDD
EDGDDDMDDDGDDDDDMMDDDDDD
EEEEEEDDDDDDDDDDDDDDDDDD
EEDDDDDDDDDEEDDDDDDDDDDD
EEDDDDDDDDDDDDDDDDDDDDDD
DEEEEEDDDDDDGDDDDDDDDDDD
DEEDDEEEEEEHDDDDDDDDDDDD
DDDDDDEEEDDDDDDDGDDDGDDD
GDDDMDDEEEDEEEEEDDDDDDDD
DDDEEDDDEDDDDDDDDDDDDDDD
DDDDDEDEEEEDDEEDDDDDDDDD
DDDDDDDDMDDMDMDDDDMDDDDD
DDDDDDDGGDDGDGDDDDDDDDDD
GDDDDDDDDDDDDDDDDDDDDDDG